NO ./path_to_the_north_texture
SO ./path_to_the_south_texture
WE ./path_to_the_west_texture
C 210,30,5
EA ./path_to_the_east_texture
F 255,100,10




        1111111111111111111111111
        1000000100110000000000001
        1011000001110000000000001
        1001000000000000000000001
111111111011000001110000000000001
10000000001100000111011111111111
11110111111111011100000010001
11110111111111111111010010001
11000000111       10000010001
10000000001       10000010001
10000000001       11010010001
11000001110111111111011110N011
11110111 1110101 101111010001
11111111 1111111 111111111111